3 1 7 1 1 1 1 1 1 1 7 1 1 1 1 1 7 1 1 4
2 12 5 1 1 1 4 0 0 0 2 0 0 0 0 0 2 0 14 2 
2 0 0 0 0 3 6 0 2 0 2 0 1 7 1 0 0 0 0 2
2 0 3 1 1 6 0 0 2 0 2 0 0 2 0 0 1 1 1 8
2 0 5 1 1 1 0 1 8 0 5 4 0 2 0 1 1 1 1 8
2 0 0 0 0 0 0 0 2 0 0 2 0 2 0 0 0 0 0 2
2 14 3 1 1 1 4 0 10 1 0 2 0 2 0 1 1 1 1 8
10 1 6 0 0 0 2 0 2 0 0 0 0 2 0 0 1 1 1 8
2 14 0 0 2 0 0 0 2 0 3 1 1 6 14 0 0 0 13 2
5 1 1 1 9 1 1 1 9 1 9 1 1 1 1 1 1 1 1 6