1 1 1 1 1 1 1 1 1 1 1 1 1 1 1 1 1 1 1 1 
1 12 1 14 0 0 0 0 0 1 0 0 0 0 1 1 0 0 14 1
1 0 1 1 1 1 1 1 0 1 1 1 1 0 0 0 0 0 0 1
1 0 0 0 0 0 0 1 0 0 0 1 1 0 1 0 1 1 1 1
1 1 1 0 1 1 0 1 0 1 0 1 1 0 1 0 0 0 1 1
1 0 1 0 0 1 0 1 0 1 0 0 1 0 1 0 0 0 1 1
1 0 0 0 0 1 0 1 0 1 0 0 1 0 1 0 1 0 0 1
1 0 0 1 1 1 0 1 0 1 0 0 1 1 1 0 1 1 0 1
1 14 0 1 0 0 0 0 0 1 14 0 0 0 0 0 0 1 13 1
1 1 1 1 1 1 1 1 1 1 1 1 1 1 1 1 1 1 1 1
